111111111111111111111111111
1000000000000000000000000E1
111111100000000000000000001
1C000C100000000000000000001
100000100000000000000000001
1000000000000000P0000000001
100000000000000000000000001
111111100000000000000000001
1C000C100000000000000000001
100000100000000000000000001
100000000000000000000000001
111111111111111111111111111