11111111111111111111
1P100000000000000001
1010000S000011111001
101C11111110010C1001
101CE1C0001001011001
101111111010C1010001
1010000000111101C101
10000000000000011101
11101111110000000101
1C00000000001110C101
1010001111101C111101
1011101C001010000001
10010010001011111101
10010110101000000001
10110000101111111101
101C0111100000000001
101111001C0011111101
100000001111100C1001
1C0000001000000000C1
11111111111111111111