1111111111
1P1CC100C1
10100100C1
10101100C1
10000000C1
1000001111
1000000001
1111110001
1E000000C1
1111111111