11111111111111111111111111111111111
100000000000000000000000000000000E1
11111110000000000000000000000111111
1C000C100000000000000000000001C00C1
10000010000000000000000000000100001
1000000000000000P000000000000000001
10000000000000000000000000000000001
11111110000000000000000000000111111
1C000C100000000000000000000001C00C1
10000010000000000000000000000100001
10000000000000000000000000000000001
11111111111111111111111111111111111